MouseDesktopX = MouseHookX;
MouseDesktopY = MouseHookY;
SendWheelUp = MouseHookWheelUp;
SendWheelDown = MouseHookWheelDown;
SendLeftClick = MouseHookLeftButton;
SendRightClick = MouseHookRightButton;
SendReturn = Key_Return;
SendEscape = Key_Escape;
SendSHIFT = Key_SHIFT;
SendCONTROL = Key_CONTROL;
SendA = Key_A;
SendB = Key_B;
SendC = Key_C;
SendD = Key_D;
SendE = Key_E;
SendF = Key_F;
SendG = Key_G;
SendH = Key_H;
SendI = Key_I;
SendJ = Key_J;
SendK = Key_K;
SendL = Key_L;
SendM = Key_M;
SendN = Key_N;
SendO = Key_O;
SendP = Key_P;
SendQ = Key_Q;
SendR = Key_R;
SendS = Key_S;
SendT = Key_T;
SendU = Key_U;
SendV = Key_V;
SendX = Key_X;
SendY = Key_Y;
SendZ = Key_Z;
